R 1024 748
NO ./textures/north.xpm
SO 			./textures/south.xpm	
WE    		  ./textures/west.xm   
EA    		  ./textures/east.xpm    
S    		  ./textures/sprite.xpm    

F 			220,100,0
C 225,0,98

       
        1111111111111111111111111
        10000000000000000E0000001
        11111111111111111111