R 1024 748
NO ./textures/north.xpm
SO ./textures/south.xpm
WE ./textures/west.xpm
EA ./textures/east.xpm

S ./textures/sprite.xpm
F 220,100,0
C 225,0,98

111111
100101
102001
1100N1
111111